##########
#      > #
#      ###
#       *#
#        #
#        #
#        #
#        #
#        #
##########